111111111111111
1P1C0000M0000C1
101111110111111
101C001101110C1
101110000000011
100001110111111
100001110111111
1000C00000000E1
100001110111111
100001C10111111
101111010000011
1011110001110C1
101111110111111
1C1C000000000C1
111111111111111