111111111111111111111
100010C00000000000001
100011100000000000001
1P0000000000000000001
100000000000000000001
100C00000000000000001
100000000000000000001
100000C00000000000001
1E0000000000000000001
100000000000000000001
100000000000001000001
1000000C000000C000001
100000000000000000001
100000000000000000001
100000000000000000001
10000C000000000000001
100000000000000000001
1000000C0000000000001
10000C000000000000001
100000000000000000001
100000000000000000001
100000000000000000001
100000000000000000001
111111111111111111111