111111111111111111
1CCCCCCCCCCC11CCC1
1C1111C1111C11C1C1
111111C10000001111
111111C10111101111
1CECCCCCCCCCCCCCC1
1C1111C1111C1111C1
1CCC11CCCCCC0PCCC1
1CCCCCCCCCCCCCCCC1
111111111111111111