111111111111111111111
100010C00000000000001
100011100000000111111
1P0000000000001100001
100000000000000100C01
100C00000000000100001
100000000000000111101
100000C00000000000001
1E0000000000000000001
100000000000000000001
100000000000001000001
1000000C000000C000001
100000000000000000001
111111111111111111111