1111111111111
1P0000CE11111
1111111111111
