111111111111111
100000000000001
101011111111111
101000000000001
101111111111101
100010000010001
111011101110101
100000001000101
101110111011101
101010100010101
101011101110101
101000101000101
101110101011101
100010001000001
111111111111111