11111111111111
100000000001P1
10000000000101
10000000000101
100000CE100101
10000000000101
10000010000101
10000000000101
11111111111111
