111111111111111111111111111111111111
1CCCCCCCCCCC11CCC1111111111111111111
1C1111C1111C11C1C1111111111111111111
111111C10000001111111111110P01111111
111111C10111101111111111111111111111
1CECCCCCCCCCCCCCC1111111111111111111
1C1111C1111C1111C1111111111111111111
1CCC11CCCCCC00CCC1111111111111111111
1CCCCCCCCCCCCCCCC1111111111111111111
111111111111111111111111111111111111