1111111111111111111111111
1001001000000101000000111
1011001110000101000100111
1000000010000101000011111
1000000000000000000000111
1000111111111111111011111
1000111111111111111011111
101011E0000000C0000000011
1100110000000000000000011
1110110011111011111111011
1110110011111011111111011
1110110011111P11111111011
1110000000001110000000111
1110000000000000000001111
1110000M00000000000001101
1110000000000000000011101
1000000000000000000110001
1000000000000000000110001
1000000000000000000110001
1111111111111111111111111